XXXXXXX        XXXXXXXXXXXXXXXXXXXXXXXXXXXX
X                                          
XXXX             XXXXX                 X   
   X                 XXXXXXXXXXXX      X   
   X                 X             XXXXXX
 X X   X  XXXXXXXXXXXX     X       X
 X X   X                   X       XXX
 XXX   XXXX      X         XXXXXXXXX
          X      XXXXX                X
          X          X                X